
~~~~~~~~~~~ Configuration Settings ~~~~~~~~~

N: 72
K: 64
rows: 8
max_weight: 3
explore_coeff: 2.000000
depth_coeff: 0.000000
num_searches: 400
num_games: 1
experiment_runs: 1
enable_shared_memory: 1
enable_verbatim: 0
num_threads: 1
enable_action_space_splitting: 1
splitting_col: 36
left_weight: 2
right_weight: 3
enable_highscore: 0
heating_rate: 1.075000
heating_column_limit: 42


~~~~~~~~~~~~~~~~~~~~~~~~~~~~~~~~~~

No matrix found yet... :(


N72K64
-----------------------------------
Found @ iteration: 55 ; game = 1 
After 14.136 seconds
# Bad Cycles: 625
# Set Bits:   172
# Max Row Weight: 24
col 1 : (0 0 0 0 1 0 0 1 )
col 2 : (1 0 0 0 0 0 0 0 )
col 3 : (0 0 0 1 1 0 0 0 )
col 4 : (0 1 0 0 0 0 0 0 )
col 5 : (0 0 0 0 0 0 1 1 )
col 6 : (0 0 1 0 0 0 0 0 )
col 7 : (0 1 0 0 0 0 1 0 )
col 8 : (0 0 0 1 0 0 0 0 )
col 9 : (0 0 1 0 0 1 0 0 )
col 10: (0 0 0 0 1 0 0 0 )
col 11: (0 0 1 0 0 0 1 0 )
col 12: (0 0 0 0 0 1 0 0 )
col 13: (0 1 0 0 1 0 0 0 )
col 14: (0 0 0 0 0 0 1 0 )
col 15: (1 1 0 0 0 0 0 0 )
col 16: (0 0 0 0 0 0 0 1 )
col 17: (0 0 1 1 0 0 0 0 )
col 18: (0 0 0 0 0 1 1 0 )
col 19: (0 0 1 0 0 0 0 1 )
col 20: (1 0 0 0 0 0 1 0 )
col 21: (0 0 0 1 0 1 0 0 )
col 22: (0 1 1 0 0 0 0 0 )
col 23: (0 0 0 1 0 0 1 0 )
col 24: (0 0 0 0 1 1 0 0 )
col 25: (1 0 0 1 0 0 0 0 )
col 26: (0 0 0 0 1 0 1 0 )
col 27: (0 0 0 1 0 0 0 1 )
col 28: (0 1 0 0 0 1 0 0 )
col 29: (1 0 0 0 1 0 0 0 )
col 30: (0 0 0 0 0 1 0 1 )
col 31: (1 0 1 0 0 0 0 0 )
col 32: (0 1 0 0 0 0 0 1 )
col 33: (1 0 0 0 0 1 0 0 )
col 34: (0 1 0 1 0 0 0 0 )
col 35: (1 0 0 0 0 0 0 1 )
col 36: (0 0 1 0 1 0 0 0 )
col 37: (0 1 0 0 0 1 1 0 )
col 38: (0 1 0 1 0 0 0 1 )
col 39: (1 1 1 0 0 0 0 0 )
col 40: (1 0 0 0 1 0 1 0 )
col 41: (1 0 1 1 0 0 0 0 )
col 42: (1 0 0 0 0 0 1 1 )
col 43: (0 1 0 1 0 1 0 0 )
col 44: (1 0 0 1 0 0 1 0 )
col 45: (0 0 0 1 1 0 0 1 )
col 46: (0 0 1 0 0 1 0 1 )
col 47: (0 0 0 1 1 0 1 0 )
col 48: (1 0 1 0 0 0 1 0 )
col 49: (1 0 0 0 1 1 0 0 )
col 50: (0 0 1 1 0 0 1 0 )
col 51: (1 1 0 1 0 0 0 0 )
col 52: (0 0 1 0 1 0 0 1 )
col 53: (1 0 0 0 0 1 0 1 )
col 54: (0 1 1 0 0 0 0 1 )
col 55: (1 0 0 0 0 1 1 0 )
col 56: (0 1 1 1 0 0 0 0 )
col 57: (1 0 1 0 1 0 0 0 )
col 58: (0 0 0 1 0 1 0 1 )
col 59: (0 0 1 1 1 0 0 0 )
col 60: (0 1 0 0 0 1 0 1 )
col 61: (0 0 0 1 0 0 1 1 )
col 62: (0 0 0 1 1 1 0 0 )
col 63: (0 1 1 0 0 1 0 0 )
col 64: (0 0 0 0 0 1 1 1 )
col 65: (1 0 0 1 0 1 0 0 )
col 66: (0 0 0 0 1 1 0 1 )
col 67: (1 1 0 0 0 1 0 0 )
col 68: (0 0 0 0 1 0 1 1 )
col 69: (1 0 1 0 0 0 0 1 )
col 70: (0 0 0 1 0 1 1 0 )
col 71: (0 1 1 0 1 0 0 0 )
col 72: (0 0 1 1 0 0 0 1 )
144 1 24 2 192 4 66 8 36 16 68 32 18 64 3 128 12 96 132 65 40 6 72 48 9 80 136 34 17 160 5 130 33 10 129 20 98 138 7 81 13 193 42 73 152 164 88 69 49 76 11 148 161 134 97 14 21 168 28 162 200 56 38 224 41 176 35 208 133 104 22 140 



N72K64
-----------------------------------
Found @ iteration: 55 ; game = 1 
After 14.163 seconds
# Bad Cycles: 630
# Set Bits:   172
# Max Row Weight: 23
col 1 : (0 0 0 0 1 0 0 1 )
col 2 : (1 0 0 0 0 0 0 0 )
col 3 : (0 0 0 1 1 0 0 0 )
col 4 : (0 1 0 0 0 0 0 0 )
col 5 : (0 0 0 0 0 0 1 1 )
col 6 : (0 0 1 0 0 0 0 0 )
col 7 : (0 1 0 0 0 0 1 0 )
col 8 : (0 0 0 1 0 0 0 0 )
col 9 : (0 0 1 0 0 1 0 0 )
col 10: (0 0 0 0 1 0 0 0 )
col 11: (0 0 1 0 0 0 1 0 )
col 12: (0 0 0 0 0 1 0 0 )
col 13: (0 1 0 0 1 0 0 0 )
col 14: (0 0 0 0 0 0 1 0 )
col 15: (1 1 0 0 0 0 0 0 )
col 16: (0 0 0 0 0 0 0 1 )
col 17: (0 0 1 1 0 0 0 0 )
col 18: (0 0 0 0 0 1 1 0 )
col 19: (0 0 1 0 0 0 0 1 )
col 20: (1 0 0 0 0 0 1 0 )
col 21: (0 0 0 1 0 1 0 0 )
col 22: (0 1 1 0 0 0 0 0 )
col 23: (0 0 0 1 0 0 1 0 )
col 24: (0 0 0 0 1 1 0 0 )
col 25: (1 0 0 1 0 0 0 0 )
col 26: (0 0 0 0 1 0 1 0 )
col 27: (0 0 0 1 0 0 0 1 )
col 28: (0 1 0 0 0 1 0 0 )
col 29: (1 0 0 0 1 0 0 0 )
col 30: (0 0 0 0 0 1 0 1 )
col 31: (1 0 1 0 0 0 0 0 )
col 32: (0 1 0 0 0 0 0 1 )
col 33: (1 0 0 0 0 1 0 0 )
col 34: (0 1 0 1 0 0 0 0 )
col 35: (1 0 0 0 0 0 0 1 )
col 36: (0 0 1 0 1 0 0 0 )
col 37: (0 1 0 0 0 1 1 0 )
col 38: (0 1 0 1 0 0 0 1 )
col 39: (1 1 1 0 0 0 0 0 )
col 40: (1 0 0 0 1 0 1 0 )
col 41: (1 0 1 1 0 0 0 0 )
col 42: (1 0 0 0 0 0 1 1 )
col 43: (0 1 0 1 0 1 0 0 )
col 44: (1 0 0 1 0 0 1 0 )
col 45: (0 0 0 1 1 0 0 1 )
col 46: (0 0 1 0 0 1 0 1 )
col 47: (0 0 0 1 1 0 1 0 )
col 48: (1 0 1 0 0 0 1 0 )
col 49: (1 0 0 0 1 1 0 0 )
col 50: (0 0 1 1 0 0 1 0 )
col 51: (1 1 0 1 0 0 0 0 )
col 52: (0 0 1 0 1 0 0 1 )
col 53: (1 0 0 0 0 1 0 1 )
col 54: (0 1 1 0 0 0 0 1 )
col 55: (1 0 0 0 0 1 1 0 )
col 56: (0 1 1 1 0 0 0 0 )
col 57: (1 0 1 0 1 0 0 0 )
col 58: (0 0 0 1 0 1 0 1 )
col 59: (0 0 1 1 1 0 0 0 )
col 60: (0 1 0 0 0 1 0 1 )
col 61: (0 0 0 1 0 0 1 1 )
col 62: (0 0 0 1 1 1 0 0 )
col 63: (0 1 1 0 0 1 0 0 )
col 64: (1 0 0 1 0 0 0 1 )
col 65: (1 0 1 0 0 1 0 0 )
col 66: (0 0 0 0 1 1 1 0 )
col 67: (1 0 1 0 0 0 0 1 )
col 68: (1 1 0 0 1 0 0 0 )
col 69: (0 0 0 0 0 1 1 1 )
col 70: (0 1 1 0 1 0 0 0 )
col 71: (0 0 0 1 0 1 1 0 )
col 72: (0 0 0 0 1 0 1 1 )
144 1 24 2 192 4 66 8 36 16 68 32 18 64 3 128 12 96 132 65 40 6 72 48 9 80 136 34 17 160 5 130 33 10 129 20 98 138 7 81 13 193 42 73 152 164 88 69 49 76 11 148 161 134 97 14 21 168 28 162 200 56 38 137 37 112 133 19 224 22 104 208 



N72K64
-----------------------------------
Found @ iteration: 58 ; game = 1 
After 14.999 seconds
# Bad Cycles: 628
# Set Bits:   172
# Max Row Weight: 22
col 1 : (0 0 0 0 1 0 0 1 )
col 2 : (1 0 0 0 0 0 0 0 )
col 3 : (0 0 0 1 1 0 0 0 )
col 4 : (0 1 0 0 0 0 0 0 )
col 5 : (0 0 0 0 0 0 1 1 )
col 6 : (0 0 1 0 0 0 0 0 )
col 7 : (0 1 0 0 0 0 1 0 )
col 8 : (0 0 0 1 0 0 0 0 )
col 9 : (0 0 1 0 0 1 0 0 )
col 10: (0 0 0 0 1 0 0 0 )
col 11: (0 0 1 0 0 0 1 0 )
col 12: (0 0 0 0 0 1 0 0 )
col 13: (0 1 0 0 1 0 0 0 )
col 14: (0 0 0 0 0 0 1 0 )
col 15: (1 1 0 0 0 0 0 0 )
col 16: (0 0 0 0 0 0 0 1 )
col 17: (0 0 1 1 0 0 0 0 )
col 18: (0 0 0 0 0 1 1 0 )
col 19: (0 0 1 0 0 0 0 1 )
col 20: (1 0 0 0 0 0 1 0 )
col 21: (0 0 0 1 0 1 0 0 )
col 22: (0 1 1 0 0 0 0 0 )
col 23: (0 0 0 1 0 0 1 0 )
col 24: (0 0 0 0 1 1 0 0 )
col 25: (1 0 0 1 0 0 0 0 )
col 26: (0 0 0 0 1 0 1 0 )
col 27: (0 0 0 1 0 0 0 1 )
col 28: (0 1 0 0 0 1 0 0 )
col 29: (1 0 0 0 1 0 0 0 )
col 30: (0 0 0 0 0 1 0 1 )
col 31: (1 0 1 0 0 0 0 0 )
col 32: (0 1 0 0 0 0 0 1 )
col 33: (1 0 0 0 0 1 0 0 )
col 34: (0 1 0 1 0 0 0 0 )
col 35: (1 0 0 0 0 0 0 1 )
col 36: (0 0 1 0 1 0 0 0 )
col 37: (0 1 0 0 0 1 1 0 )
col 38: (0 1 0 1 0 0 0 1 )
col 39: (1 1 1 0 0 0 0 0 )
col 40: (1 0 0 0 1 0 1 0 )
col 41: (1 0 1 1 0 0 0 0 )
col 42: (1 0 0 0 0 0 1 1 )
col 43: (0 1 0 1 0 1 0 0 )
col 44: (1 0 0 1 0 0 1 0 )
col 45: (0 0 0 1 1 0 0 1 )
col 46: (0 0 1 0 0 1 0 1 )
col 47: (0 0 0 1 1 0 1 0 )
col 48: (1 0 1 0 0 0 1 0 )
col 49: (1 0 0 0 1 1 0 0 )
col 50: (0 0 1 1 0 0 1 0 )
col 51: (1 1 0 1 0 0 0 0 )
col 52: (0 0 1 0 1 0 0 1 )
col 53: (1 0 0 0 0 1 0 1 )
col 54: (0 1 1 0 0 0 0 1 )
col 55: (1 0 0 0 0 1 1 0 )
col 56: (0 1 1 1 0 0 0 0 )
col 57: (1 0 1 0 1 0 0 0 )
col 58: (0 0 0 1 0 1 0 1 )
col 59: (0 0 1 1 1 0 0 0 )
col 60: (0 1 0 0 0 1 0 1 )
col 61: (0 0 0 1 0 0 1 1 )
col 62: (0 0 0 1 1 1 0 0 )
col 63: (0 1 1 0 0 1 0 0 )
col 64: (1 0 0 1 0 0 0 1 )
col 65: (1 0 1 0 0 1 0 0 )
col 66: (0 1 0 0 1 0 0 1 )
col 67: (0 0 0 0 1 1 1 0 )
col 68: (1 1 0 0 0 1 0 0 )
col 69: (0 0 0 0 1 0 1 1 )
col 70: (0 1 1 0 1 0 0 0 )
col 71: (0 0 0 0 1 1 0 1 )
col 72: (0 1 1 0 0 0 1 0 )
144 1 24 2 192 4 66 8 36 16 68 32 18 64 3 128 12 96 132 65 40 6 72 48 9 80 136 34 17 160 5 130 33 10 129 20 98 138 7 81 13 193 42 73 152 164 88 69 49 76 11 148 161 134 97 14 21 168 28 162 200 56 38 137 37 146 112 35 208 22 176 70 



=====================
Execution time: 15.733 seconds
